111111111111111111111111111111111111111111111111111111111111111111111111111111111111111111111111111111111111111111111111111111111111111111
1PCCCC1CCCCCCCCC1CCCCE11111111111111111111111111111111111111111111111111111111111111111111111111111111111111111111111111111111111111111111
11111C1C1111111C1C111111111111111111111111111111111111111111111111111111111111111111111111111111111111111111111111111111111111111111111111
1CCC1C1CCCCCCCCC1C1CCC11111111111111111111111111111111111111111111111111111111111111111111111111111111111111111111111111111111111111111111
1C1C1C1C1C111C1C1C1C1C11111111111111111111111111111111111111111111111111111111111111111111111111111111111111111111111111111111111111111111
1CCC1C1C1C101C1C1C1CCC11111111111111111111111111111111111111111111111111111111111111111111111111111111111111111111111111111111111111111111
111C1C1C1C111C1C1C1C1111111111111111111111111111111111111111111111111111111111111111111111111111111111111111111111111111111111111111111111
1CCCCCCC1CCCCC1CCCCCCC11111111111111111111111111111111111111111111111111111111111111111111111111111111111111111111111111111111111111111111
1C1C1C11111C11111C1C1C11111111111111111111111111111111111111111111111111111111111111111111111111111111111111111111111111111111111111111111
1CCC1CCCCCCCCCCCCC1CCC11111111111111111111111111111111111111111111111111111111111111111111111111111111111111111111111111111111111111111111
111111111111111111111111111111111111111111111111111111111111111111111111111111111111111111111111111111111111111111111111111111111111111111
111111111111111111111111111111111111111111111111111111111111111111111111111111111111111111111111111111111111111111111111111111111111111111
111111111111111111111111111111111111111111111111111111111111111111111111111111111111111111111111111111111111111111111111111111111111111111
111111111111111111111111111111111111111111111111111111111111111111111111111111111111111111111111111111111111111111111111111111111111111111
111111111111111111111111111111111111111111111111111111111111111111111111111111111111111111111111111111111111111111111111111111111111111111
111111111111111111111111111111111111111111111111111111111111111111111111111111111111111111111111111111111111111111111111111111111111111111
111111111111111111111111111111111111111111111111111111111111111111111111111111111111111111111111111111111111111111111111111111111111111111
111111111111111111111111111111111111111111111111111111111111111111111111111111111111111111111111111111111111111111111111111111111111111111
111111111111111111111111111111111111111111111111111111111111111111111111111111111111111111111111111111111111111111111111111111111111111111
111111111111111111111111111111111111111111111111111111111111111111111111111111111111111111111111111111111111111111111111111111111111111111
111111111111111111111111111111111111111111111111111111111111111111111111111111111111111111111111111111111111111111111111111111111111111111
111111111111111111111111111111111111111111111111111111111111111111111111111111111111111111111111111111111111111111111111111111111111111111
111111111111111111111111111111111111111111111111111111111111111111111111111111111111111111111111111111111111111111111111111111111111111111
111111111111111111111111111111111111111111111111111111111111111111111111111111111111111111111111111111111111111111111111111111111111111111
111111111111111111111111111111111111111111111111111111111111111111111111111111111111111111111111111111111111111111111111111111111111111111
111111111111111111111111111111111111111111111111111111111111111111111111111111111111111111111111111111111111111111111111111111111111111111
111111111111111111111111111111111111111111111111111111111111111111111111111111111111111111111111111111111111111111111111111111111111111111
111111111111111111111111111111111111111111111111111111111111111111111111111111111111111111111111111111111111111111111111111111111111111111
111111111111111111111111111111111111111111111111111111111111111111111111111111111111111111111111111111111111111111111111111111111111111111
