11111111111111111111111
1PCC1CCCCCCCCCCCCC1CCC1
1E1C1C11111C11111C1C1C1
1CCCCCCC1CCCCC1CCCCCCC1
111C1C1C1C111C1C1C1C111
1CCC1C1C1C101C1C1C1CCC1
1C1C1C1C1C111C1C1C1C1C1
1CCC1C1CCCCCCCCC1C1CCC1
11111C1C1111111C1C11111
1CCCCC1CCCCCCCCC1CCCCC1
11111111111111111111111